#########################
#.......................#
#...G###........E...##..#
#...####............##..#
#...........##......##..#
#...........##......##..#
#...........##..........#
#...#..#######..........#
#...#.G#................#
#....#..##......####....#
#.....#G..#.....#G..#####
#...................#...#
#########################